1111111111
1000000001
10C0C00001
100000P001
100000E001
1000000001
1000000001
1000000001
100000001
1111111111
