111111111111
1000C0000001
10000000P001
100000000E01
111111111111
